33.ox
......o...
.ooo......
..........
.o.....o.o
.......o..
....o.....
o..oo.o...
...o...o..
..........
......o...
...o......
......o...
.....o....
o.....o...
.o..o.....
......oo.o
o.........
....o.....
........o.
.oo......o
o.........
..o.......
....o.o.o.
.o........
..........
.......o..
.....o....
......o.o.
.........o
..........
........oo
o.oo......
..o.......
